WWWWWWWWWWW
WAOOOOOOOAW
WOOOOOOOOOW
WOOOOOOOOOW
WAOOOBOOOAW
WWWWWWWWWWW
