WWWWWWWWWWW
WAO!!!!!OAW
WOOO!!!O  W
WOOOO!OOO W
WOOOOBOOOOW
WOOOOOOOOOW
WOOOOBOOOOW
WOOOO!OOO W
WOOO!!!O  W
WAO!!!!!OAW
WWWWWWWWWWW
