WWWWWWWWWWWWW
W1  OOOWO  2W
W  O W O O  W
W  O  WOOW  W
WWO WWWOOOOOW
WOOO  O O W W
WO  OO WO W W
W OOO OWOOO W
W WO OOOWWW W
W3  OOOWO  4W
WWWWWWWWWWWWW
